TST = "countries/Test.txt"
SAV = "countries/Savras.txt"
RYZ = "countries/Ryzan.txt"
NDR = "countries/NDR.txt"
BAR = "countries/Bardonia.txt"
AUR = "countries/Auron.txt"
VAL = "countries/Vallia.txt"
NSV = "countries/NSV.txt"
WIV = "countries/WIV.txt"
TAR = "countries/TAR.txt"
LEN = "countries/LEN.txt"
HEL = "countries/HEL.txt"
NRF = "countries/NRF.txt"
BIZ = "countries/BIZ.txt"
ARL = "countries/ARL.txt"
NIE = "countries/NIE.txt"
AGN = "countries/AGN.txt"
VIR = "countries/VIR.txt"
HUI = "countries/HUI.txt"
ARD = "countries/ARD.txt"
SOL = "countries/SOL.txt"
SEW = "countries/SEW.txt"
SIN = "countries/SIN.txt"
CAP = "countries/CAP.txt"
KOC = "countries/KOC.txt"
FER = "countries/FER.txt"
INA = "countries/INA.txt"
ULD = "countries/ULD.txt"
FAL = "countries/FAL.txt"
TRF = "countries/TRF.txt"
CAV = "countries/CAV.txt"
THI = "countries/THI.txt"
SRF = "countries/SRF.txt"
SIR = "countries/SIR.txt"
COB = "countries/COB.txt"
HIN = "countries/HIN.txt"
ATH = "countries/ATH.txt"
SOU = "countries/SOU.txt"
REG = "countries/REG.txt"
CIR = "countries/CIR.txt"
LOT = "countries/LOT.txt"
VAN = "countries/VAN.txt"
SCH = "countries/SCH.txt"
FRO = "countries/FRO.txt"
KUS = "countries/KUS.txt"
TOR = "countries/TOR.txt"
PAH = "countries/PAH.txt"
VIO = "countries/VIO.txt"
AKR = "countries/AKR.txt"
GRN = "countries/GRN.txt"
LEY = "countries/LEY.txt"
SRF= "countries/SRF.txt"
AVR = "countries/AVR.txt"
POS = "countries/POS.txt"
SHR = "countries/SHR.txt"
AEZ = "countries/AEZ.txt"
UBS = "countries/UBS.txt"
TTO = "countries/TTO.txt"
VRA = "countries/VRA.txt"
FJE = "countries/FJE.txt"
AXR = "countries/AXR.txt"
FJ1 = "countries/FJ1.txt"
MDR = "countries/MDR.txt"
HLG = "countries/HLG.txt"
OWY = "countries/OWY.txt"
LUM = "countries/LUM.txt"
ALI = "countries/ALI.txt"
FLR = "countries/FLR.txt"
MUV = "countries/MUV.txt"
KRO = "countries/KRO.txt"
NAJ = "countries/NAJ.txt"
PLG = "countries/PLG.txt"
SLT = "countries/SLT.txt"
THR = "countries/THR.txt"
CHR = "countries/CHR.txt"
TRT = "countries/TRT.txt"
IRM = "countries/IRM.txt"
PIK = "countries/PIK.txt"
NRM = "countries/NRM.txt"
PLR = "countries/PLR.txt"
ARA = "countries/ARA.txt"
CHE = "countries/CHE.txt"
MOT = "countries/MOT.txt"
SAN = "countries/SAN.txt"
BOU = "countries/BOU.txt"
ASK = "countries/ASK.txt"
NEB = "countries/NEB.txt"
DEU = "countries/DEU.txt"
EME = "countries/EME.txt"
EOK = "countries/EOK.txt"
DOF = "countries/DOF.txt"
NRG = "countries/NRG.txt"
ALO = "countries/ALO.txt"
NLA = "countries/NUL.txt"
PRS = "countries/PRS.txt"
PLD = "countries/PLD.txt"
UNT = "countries/UNT.txt"
OST = "countries/OST.txt"
KOT = "countries/KOT.txt"
AZU = "countries/AZU.txt"
AXU = "countries/AXU.txt"
RAV = "countries/RAV.txt"
CLI = "countries/CLI.txt"
DAE = "countries/DAE.txt"
ONE = "countries/ONE.txt"
MAU = "countries/MAU.txt"
SKI = "countries/SKI.txt"
AVA = "countries/AVA.txt"
SHI = "countries/SHI.txt"
THE = "countries/THE.txt"
ROS = "countries/ROS.txt"
SIV = "countries/SIV.txt"
SHA = "countries/SHA.txt"
TVE = "countries/TVE.txt"
VAR = "countries/VAR.txt"
OPT = "countries/OPT.txt"
ASY = "countries/ASY.txt"
REY = "countries/REY.txt"